 
NO ../assests/textures/NO.xpm
SO ../assests/textures/SO.xpm
EA ../assests/textures/EA.xpm
WE ../assests/textures/WE.xpm

F 255,0,0
C 0,255,0





111111111111
10000000E001
100000000001
111111111111




