NO
SO
WE
EA

F
C





111111111111
10000000E001
100000000001
111111111111




