 
NO A
SO B
WE C
EA D

F 1
C 2





111111111111
10000000E001
100000000001
111111111111




