NO ./assests/textures/KU.xpm
SO ./assests/textures/GU.xpm
EA ./assests/textures/DO.xpm
WE ./assests/textures/BA.xpm

F 255,127,64
C 0,1,255




      
111111111111111
100000000000001
100010000000001
100010S00000001
100010100000001
100000000000001
100000000000001
100000000000001
100000000000001
111111111111111 




