NO ./assests/textures/kanzee5.xpm
NO ./assests/textures/kanzee5.xpm
SO ./assests/textures/kanzee2.xpm
SO ./assests/textures/kanzee2.xpm
EA ./assests/textures/kanzee3.xpm
EA ./assests/textures/kanzee3.xpm
WE ./assests/textures/kanzee4.xpm
WE ./assests/textures/kanzee4.xpm

F 120,80,10
F 120,80,10
C 0,80,160
C 0,80,160




      
111111111111111
100000000000001
100010000000001
100010S00000001
100010100000001
100000000000001
100000000000001
100000000000001
100000000000001
111111111111111 




